[LINKS]
ADD BITMAP TO BLOCK=addoncommands\Enhancements\ADD BITMAP TO BLOCK.htm=id, bitmap, filename
ADD FILE TO BLOCK=addoncommands\Enhancements\ADD FILE TO BLOCK.htm=ID, File
ADD IMAGE TO BLOCK=addoncommands\Enhancements\ADD IMAGE TO BLOCK.htm=id, object, filename
ADD OBJECT TO BLOCK=addoncommands\Enhancements\ADD OBJECT TO BLOCK.htm=id, object, filename
APPLY PRESET EAX EFFECT=addoncommands\Enhancements\APPLY PRESET EAX EFFECT.htm=Sound, Effect
CLOSE DATA FILE=addoncommands\Enhancements\CLOSE DATA FILE.htm=Integer Value
CLOSE FILE BLOCK=addoncommands\Enhancements\CLOSE FILE BLOCK.htm=id
CLOSE FILE MAP=addoncommands\Enhancements\CLOSE FILE MAP.htm=Integer Value
CREATE FILE BLOCK=addoncommands\Enhancements\CREATE FILE BLOCK.htm=id, filename
CREATE FILE MAP=addoncommands\Enhancements\CREATE FILE MAP.htm=Integer Value, String Value, Integer Value
DELETE FILE BLOCK=addoncommands\Enhancements\DELETE FILE BLOCK.htm=ID
DESTROY FILE MAP=addoncommands\Enhancements\DESTROY FILE MAP.htm=Integer Value
EXTRACT FILE FROM BLOCK=addoncommands\Enhancements\EXTRACT FILE FROM BLOCK.htm=id, filename, path
GET CD COUNT=addoncommands\Enhancements\GET CD COUNT.htm=*no parameters*
GET CD LETTER$=addoncommands\Enhancements\GET CD LETTER$.htm=(ID)
GET COMPUTER NAME$=addoncommands\Enhancements\GET COMPUTER NAME$.htm=*no parameters*
GET DATA FILE CELL=addoncommands\Enhancements\GET DATA FILE CELL.htm=(Integer Value, Integer Value, Integer Value)
GET DATA FILE COLUMN COUNT=addoncommands\Enhancements\GET DATA FILE COLUMN COUNT.htm=(Integer Value)
GET DATA FILE EXISTS=addoncommands\Enhancements\GET DATA FILE EXISTS.htm=(ID)
GET DATA FILE ROW COUNT=addoncommands\Enhancements\GET DATA FILE ROW COUNT.htm=(Integer Value)
GET DISPLAY DEPTH=addoncommands\Enhancements\GET DISPLAY DEPTH.htm=*no parameters*
GET DISPLAY HEIGHT=addoncommands\Enhancements\GET DISPLAY HEIGHT.htm=*no parameters*
GET DISPLAY REFRESH RATE=addoncommands\Enhancements\GET DISPLAY REFRESH RATE.htm=*no parameters*
GET DISPLAY WIDTH=addoncommands\Enhancements\GET DISPLAY WIDTH.htm=*no parameters*
GET DRIVE BYTES PER SECTOR=addoncommands\Enhancements\GET DRIVE BYTES PER SECTOR.htm=(ID)
GET DRIVE COUNT=addoncommands\Enhancements\GET DRIVE COUNT.htm=*no parameters*
GET DRIVE CYLINDER COUNT=addoncommands\Enhancements\GET DRIVE CYLINDER COUNT.htm=(ID)
GET DRIVE FILE LENGTH SUPPORT=addoncommands\Enhancements\GET DRIVE FILE LENGTH SUPPORT.htm=(ID)
GET DRIVE FILE SYSTEM$=addoncommands\Enhancements\GET DRIVE FILE SYSTEM$.htm=(ID)
GET DRIVE FREE SPACE=addoncommands\Enhancements\GET DRIVE FREE SPACE.htm=(ID)
GET DRIVE SECTORS PER TRACK=addoncommands\Enhancements\GET DRIVE SECTORS PER TRACK.htm=(ID)
GET DRIVE SERIAL$=addoncommands\Enhancements\GET DRIVE SERIAL$.htm=(ID)
GET DRIVE TOTAL SIZE=addoncommands\Enhancements\GET DRIVE TOTAL SIZE.htm=(ID)
GET DRIVE TRACK COUNT=addoncommands\Enhancements\GET DRIVE TRACK COUNT.htm=(ID)
GET DRIVE USED SPACE=addoncommands\Enhancements\GET DRIVE USED SPACE.htm=(ID)
GET EAX AIR ABSORPTION=addoncommands\Enhancements\GET EAX AIR ABSORPTION.htm=(Integer Value)
GET EAX CONE INSIDE ANGLE=addoncommands\Enhancements\GET EAX CONE INSIDE ANGLE.htm=(Integer Value)
GET EAX CONE ORIENTATION X=addoncommands\Enhancements\GET EAX CONE ORIENTATION X.htm=(Integer Value)
GET EAX CONE ORIENTATION Y=addoncommands\Enhancements\GET EAX CONE ORIENTATION Y.htm=(Integer Value)
GET EAX CONE ORIENTATION Z=addoncommands\Enhancements\GET EAX CONE ORIENTATION Z.htm=(Integer Value)
GET EAX CONE OUTSIDE ANGLE=addoncommands\Enhancements\GET EAX CONE OUTSIDE ANGLE.htm=(Integer Value)
GET EAX CONE OUTSIDE VOLUME=addoncommands\Enhancements\GET EAX CONE OUTSIDE VOLUME.htm=(Integer Value)
GET EAX DECAY HF RATIO=addoncommands\Enhancements\GET EAX DECAY HF RATIO.htm=(Integer Value)
GET EAX ENVIRONMENT DIFFUSION=addoncommands\Enhancements\GET EAX ENVIRONMENT DIFFUSION.htm=(Integer Value)
GET EAX ENVIRONMENT SIZE=addoncommands\Enhancements\GET EAX ENVIRONMENT SIZE.htm=(Integer Value)
GET EAX ENVIRONMENT=addoncommands\Enhancements\GET EAX ENVIRONMENT.htm=(Integer Value)
GET EAX FLAGS=addoncommands\Enhancements\GET EAX FLAGS.htm=(Integer Value)
GET EAX MAX DISTANCE=addoncommands\Enhancements\GET EAX MAX DISTANCE.htm=(Integer Value)
GET EAX MIN DISTANCE=addoncommands\Enhancements\GET EAX MIN DISTANCE.htm=(Integer Value)
GET EAX REFLECTIONS DELAY=addoncommands\Enhancements\GET EAX REFLECTIONS DELAY.htm=(Integer Value)
GET EAX REFLECTIONS=addoncommands\Enhancements\GET EAX REFLECTIONS.htm=(Integer Value)
GET EAX REVERB DELAY=addoncommands\Enhancements\GET EAX REVERB DELAY.htm=(Integer Value)
GET EAX REVERB=addoncommands\Enhancements\GET EAX REVERB.htm=(Integer Value)
GET EAX ROOM DECAY TIME=addoncommands\Enhancements\GET EAX ROOM DECAY TIME.htm=(Integer Value)
GET EAX ROOM HF=addoncommands\Enhancements\GET EAX ROOM HF.htm=(Integer Value)
GET EAX ROOM ROLLOFF=addoncommands\Enhancements\GET EAX ROOM ROLLOFF.htm=(Integer Value)
GET EAX ROOM=addoncommands\Enhancements\GET EAX ROOM.htm=(Integer Value)
GET EAX SOURCE ABSORPTION=addoncommands\Enhancements\GET EAX SOURCE ABSORPTION.htm=(Integer Value)
GET EAX SOURCE DIRECT HF=addoncommands\Enhancements\GET EAX SOURCE DIRECT HF.htm=(Integer Value)
GET EAX SOURCE DIRECT=addoncommands\Enhancements\GET EAX SOURCE DIRECT.htm=(Integer Value)
GET EAX SOURCE FLAGS=addoncommands\Enhancements\GET EAX SOURCE FLAGS.htm=(Integer Value)
GET EAX SOURCE OBSTRUCTION LF=addoncommands\Enhancements\GET EAX SOURCE OBSTRUCTION LF.htm=(Integer Value)
GET EAX SOURCE OBSTRUCTION=addoncommands\Enhancements\GET EAX SOURCE OBSTRUCTION.htm=(Integer Value)
GET EAX SOURCE OCCLUSION LF=addoncommands\Enhancements\GET EAX SOURCE OCCLUSION LF.htm=(Integer Value)
GET EAX SOURCE OCCLUSION ROOM=addoncommands\Enhancements\GET EAX SOURCE OCCLUSION ROOM.htm=(Integer Value)
GET EAX SOURCE OCCLUSION=addoncommands\Enhancements\GET EAX SOURCE OCCLUSION.htm=(Integer Value)
GET EAX SOURCE OUTSIDE=addoncommands\Enhancements\GET EAX SOURCE OUTSIDE.htm=(Integer Value)
GET EAX SOURCE ROLLOFF=addoncommands\Enhancements\GET EAX SOURCE ROLLOFF.htm=(Integer Value)
GET EAX SOURCE ROOM HF=addoncommands\Enhancements\GET EAX SOURCE ROOM HF.htm=(Integer Value)
GET EAX SOURCE ROOM=addoncommands\Enhancements\GET EAX SOURCE ROOM.htm=(Integer Value)
GET EAX=addoncommands\Enhancements\GET EAX.htm=*no parameters*
GET FILE BLOCK COMPRESSION=addoncommands\Enhancements\GET FILE BLOCK COMPRESSION.htm=(ID)
GET FILE BLOCK COUNT=addoncommands\Enhancements\GET FILE BLOCK COUNT.htm=(ID)
GET FILE BLOCK DATA EXISTS=addoncommands\Enhancements\GET FILE BLOCK DATA EXISTS.htm=(ID, File)
GET FILE BLOCK EXISTS=addoncommands\Enhancements\GET FILE BLOCK EXISTS.htm=(ID)
GET FILE BLOCK KEY=addoncommands\Enhancements\GET FILE BLOCK KEY.htm=(ID)
GET FILE BLOCK SIZE=addoncommands\Enhancements\GET FILE BLOCK SIZE.htm=(ID)
GET FILE MAP DWORD=addoncommands\Enhancements\GET FILE MAP DWORD.htm=(Integer Value, Integer Value)
GET FILE MAP FLOAT=addoncommands\Enhancements\GET FILE MAP FLOAT.htm=(Integer Value, Integer Value)
GET FILE MAP STRING$=addoncommands\Enhancements\GET FILE MAP STRING$.htm=(Integer Value, Integer Value)
GET INSTALLED MEMORY=addoncommands\Enhancements\GET INSTALLED MEMORY.htm=(Integer Value)
GET IP ADDRESS$=addoncommands\Enhancements\GET IP ADDRESS$.htm=*no parameters*
GET MEMORY AVAILABLE=addoncommands\Enhancements\GET MEMORY AVAILABLE.htm=(Integer Value)
GET MEMORY PERCENT FREE=addoncommands\Enhancements\GET MEMORY PERCENT FREE.htm=*no parameters*
GET MEMORY PERCENT USED=addoncommands\Enhancements\GET MEMORY PERCENT USED.htm=*no parameters*
GET PROCESSOR BRAND$=addoncommands\Enhancements\GET PROCESSOR BRAND$.htm=(ID)
GET PROCESSOR COUNT=addoncommands\Enhancements\GET PROCESSOR COUNT.htm=*no parameters*
GET PROCESSOR FAMILY ID=addoncommands\Enhancements\GET PROCESSOR FAMILY ID.htm=(ID)
GET PROCESSOR FREQUENCY=addoncommands\Enhancements\GET PROCESSOR FREQUENCY.htm=(ID)
GET PROCESSOR MODEL ID=addoncommands\Enhancements\GET PROCESSOR MODEL ID.htm=(ID)
GET PROCESSOR NAME$=addoncommands\Enhancements\GET PROCESSOR NAME$.htm=(ID)
GET PROCESSOR ON CHIP FEATURES=addoncommands\Enhancements\GET PROCESSOR ON CHIP FEATURES.htm=ID
GET PROCESSOR PLATFORM$=addoncommands\Enhancements\GET PROCESSOR PLATFORM$.htm=(ID)
GET PROCESSOR POWER MANAGEMENT=addoncommands\Enhancements\GET PROCESSOR POWER MANAGEMENT.htm=ID
GET PROCESSOR STEPPING ID=addoncommands\Enhancements\GET PROCESSOR STEPPING ID.htm=(ID)
GET PROCESSOR SUPPORTED FEATURES=addoncommands\Enhancements\GET PROCESSOR SUPPORTED FEATURES.htm=ID
GET PROCESSOR TYPE ID=addoncommands\Enhancements\GET PROCESSOR TYPE ID.htm=(ID)
GET PROCESSOR USAGE=addoncommands\Enhancements\GET PROCESSOR USAGE.htm=(ID)
GET PROCESSOR VENDOR$=addoncommands\Enhancements\GET PROCESSOR VENDOR$.htm=(ID)
GET USER NAME$=addoncommands\Enhancements\GET USER NAME$.htm=*no parameters*
GET VOICE API=addoncommands\Enhancements\GET VOICE API.htm=*no parameters*
GET VOICE LIST=addoncommands\Enhancements\GET VOICE LIST.htm=*no parameters*
GET VOICE SPEED=addoncommands\Enhancements\GET VOICE SPEED.htm=*no parameters*
GET VOICE VOLUME=addoncommands\Enhancements\GET VOICE VOLUME.htm=*no parameters*
GET WEB CLIENT$=addoncommands\Enhancements\GET WEB CLIENT$.htm=*no parameters*
LOAD ANIMATION FROM BLOCK=addoncommands\Enhancements\LOAD ANIMATION FROM BLOCK.htm=ID, File, Animation
LOAD BITMAP FROM BLOCK=addoncommands\Enhancements\LOAD BITMAP FROM BLOCK.htm=ID, File, Bitmap
LOAD FILE FROM BLOCK=addoncommands\Enhancements\LOAD FILE FROM BLOCK.htm=ID, File, File ID
LOAD IMAGE FROM BLOCK=addoncommands\Enhancements\LOAD IMAGE FROM BLOCK.htm=ID, File, Image
LOAD MEMBLOCK FROM BLOCK=addoncommands\Enhancements\LOAD MEMBLOCK FROM BLOCK.htm=ID, File, Memblock
LOAD OBJECT FROM BLOCK=addoncommands\Enhancements\LOAD OBJECT FROM BLOCK.htm=ID, File, Object
LOAD SOUND FROM BLOCK=addoncommands\Enhancements\LOAD SOUND FROM BLOCK.htm=ID, File, Sound
OPEN DATA FILE=addoncommands\Enhancements\OPEN DATA FILE.htm=String Value, String Value, Integer Value
OPEN FILE BLOCK=addoncommands\Enhancements\OPEN FILE BLOCK.htm=[File, ID][File, ID, Key]
OPEN FILE DIALOG=addoncommands\Enhancements\OPEN FILE DIALOG.htm=(Directory, Filter, Title)
OPEN FILE MAP=addoncommands\Enhancements\OPEN FILE MAP.htm=Integer Value, String Value
PERFORM CHECKLIST FOR EAX EFFECTS=addoncommands\Enhancements\PERFORM CHECKLIST FOR EAX EFFECTS.htm=*no parameters*
PERFORM CHECKLIST FOR FILE BLOCK DATA=addoncommands\Enhancements\PERFORM CHECKLIST FOR FILE BLOCK DATA.htm=ID
REMOVE FILE FROM BLOCK=addoncommands\Enhancements\REMOVE FILE FROM BLOCK.htm=ID, File
SAVE FILE BLOCK=addoncommands\Enhancements\SAVE FILE BLOCK.htm=id
SAVE FILE DIALOG=addoncommands\Enhancements\SAVE FILE DIALOG.htm=(Directory, Filter, Title)
SEND VOICE MESSAGE XML=addoncommands\Enhancements\SEND VOICE MESSAGE XML.htm=Message
SEND VOICE MESSAGE=addoncommands\Enhancements\SEND VOICE MESSAGE.htm=Message
SET EAX AIR ABSORPTION=addoncommands\Enhancements\SET EAX AIR ABSORPTION.htm=Sound, Value
SET EAX CLIP DECAY HF=addoncommands\Enhancements\SET EAX CLIP DECAY HF.htm=Sound, Mode
SET EAX CONE INSIDE ANGLE=addoncommands\Enhancements\SET EAX CONE INSIDE ANGLE.htm=Sound, Value
SET EAX CONE ORIENTATION X=addoncommands\Enhancements\SET EAX CONE ORIENTATION X.htm=Sound, Value
SET EAX CONE ORIENTATION Y=addoncommands\Enhancements\SET EAX CONE ORIENTATION Y.htm=Sound, Value
SET EAX CONE ORIENTATION Z=addoncommands\Enhancements\SET EAX CONE ORIENTATION Z.htm=Sound, Value
SET EAX CONE OUTSIDE ANGLE=addoncommands\Enhancements\SET EAX CONE OUTSIDE ANGLE.htm=Sound, Value
SET EAX CONE OUTSIDE VOLUME=addoncommands\Enhancements\SET EAX CONE OUTSIDE VOLUME.htm=Sound, Value
SET EAX DECAY HF RATIO=addoncommands\Enhancements\SET EAX DECAY HF RATIO.htm=Sound, Value
SET EAX DECAY TIME=addoncommands\Enhancements\SET EAX DECAY TIME.htm=Sound, Value
SET EAX ENVIRONMENT DIFFUSION=addoncommands\Enhancements\SET EAX ENVIRONMENT DIFFUSION.htm=Sound, Value
SET EAX ENVIRONMENT SIZE=addoncommands\Enhancements\SET EAX ENVIRONMENT SIZE.htm=Sound, Value
SET EAX ENVIRONMENT=addoncommands\Enhancements\SET EAX ENVIRONMENT.htm=Sound, Value
SET EAX FLAGS=addoncommands\Enhancements\SET EAX FLAGS.htm=Sound, Value
SET EAX MAX DISTANCE=addoncommands\Enhancements\SET EAX MAX DISTANCE.htm=Sound, Value
SET EAX MIN DISTANCE=addoncommands\Enhancements\SET EAX MIN DISTANCE.htm=Sound, Value
SET EAX REFLECTIONS DELAY=addoncommands\Enhancements\SET EAX REFLECTIONS DELAY.htm=Sound, Value
SET EAX REFLECTIONS=addoncommands\Enhancements\SET EAX REFLECTIONS.htm=Sound, Value
SET EAX REVERB DELAY=addoncommands\Enhancements\SET EAX REVERB DELAY.htm=Sound, Value
SET EAX REVERB=addoncommands\Enhancements\SET EAX REVERB.htm=Sound, Value
SET EAX ROOM HF=addoncommands\Enhancements\SET EAX ROOM HF.htm=Sound, Value
SET EAX ROOM ROLLOFF=addoncommands\Enhancements\SET EAX ROOM ROLLOFF.htm=Sound, Value
SET EAX ROOM=addoncommands\Enhancements\SET EAX ROOM.htm=Sound, Value
SET EAX SCALE DECAY TIME=addoncommands\Enhancements\SET EAX SCALE DECAY TIME.htm=Sound, Mode
SET EAX SCALE REFLECTIONS DELAY=addoncommands\Enhancements\SET EAX SCALE REFLECTIONS DELAY.htm=Sound, Mode
SET EAX SCALE REFLECTIONS=addoncommands\Enhancements\SET EAX SCALE REFLECTIONS.htm=Sound, Mode
SET EAX SCALE REVERB DELAY=addoncommands\Enhancements\SET EAX SCALE REVERB DELAY.htm=Sound, Mode
SET EAX SCALE REVERB=addoncommands\Enhancements\SET EAX SCALE REVERB.htm=Sound, Mode
SET EAX SOURCE ABSORPTION=addoncommands\Enhancements\SET EAX SOURCE ABSORPTION.htm=Sound, Value
SET EAX SOURCE AFFECT DIRECT HF=addoncommands\Enhancements\SET EAX SOURCE AFFECT DIRECT HF.htm=Sound, Mode
SET EAX SOURCE AFFECT ROOM HF=addoncommands\Enhancements\SET EAX SOURCE AFFECT ROOM HF.htm=Sound, Mode
SET EAX SOURCE AFFECT ROOM=addoncommands\Enhancements\SET EAX SOURCE AFFECT ROOM.htm=Sound, Mode
SET EAX SOURCE DIRECT HF=addoncommands\Enhancements\SET EAX SOURCE DIRECT HF.htm=Sound, Value
SET EAX SOURCE DIRECT=addoncommands\Enhancements\SET EAX SOURCE DIRECT.htm=Sound, Value
SET EAX SOURCE FLAGS=addoncommands\Enhancements\SET EAX SOURCE FLAGS.htm=Sound, Value
SET EAX SOURCE OBSTRUCTION LF=addoncommands\Enhancements\SET EAX SOURCE OBSTRUCTION LF.htm=Sound, Value
SET EAX SOURCE OBSTRUCTION=addoncommands\Enhancements\SET EAX SOURCE OBSTRUCTION.htm=Sound, Value
SET EAX SOURCE OCCLUSION LF=addoncommands\Enhancements\SET EAX SOURCE OCCLUSION LF.htm=Sound, Value
SET EAX SOURCE OCCLUSION ROOM=addoncommands\Enhancements\SET EAX SOURCE OCCLUSION ROOM.htm=Sound, Value
SET EAX SOURCE OCCLUSION=addoncommands\Enhancements\SET EAX SOURCE OCCLUSION.htm=Sound, Value
SET EAX SOURCE OUTSIDE=addoncommands\Enhancements\SET EAX SOURCE OUTSIDE.htm=Sound, Value
SET EAX SOURCE ROLLOFF=addoncommands\Enhancements\SET EAX SOURCE ROLLOFF.htm=Sound, Value
SET EAX SOURCE ROOM=addoncommands\Enhancements\SET EAX SOURCE ROOM.htm=Sound, Value
SET FILE BLOCK COMPRESSION=addoncommands\Enhancements\SET FILE BLOCK COMPRESSION.htm=ID, Flag
SET FILE BLOCK KEY=addoncommands\Enhancements\SET FILE BLOCK KEY.htm=ID, Key
SET FILE MAP DWORD=addoncommands\Enhancements\SET FILE MAP DWORD.htm=Integer Value, Integer Value, Integer Value
SET FILE MAP FLOAT=addoncommands\Enhancements\SET FILE MAP FLOAT.htm=Integer Value, Integer Value, Float Value
SET FILE MAP STRING$=addoncommands\Enhancements\SET FILE MAP STRING$.htm=Integer Value, Integer Value, String Value
SET VOICE SPEED=addoncommands\Enhancements\SET VOICE SPEED.htm=Speed
SET VOICE VOLUME=addoncommands\Enhancements\SET VOICE VOLUME.htm=Volume
SET VOICE=addoncommands\Enhancements\SET VOICE.htm=Voice Index
UPDATE DATA FILE=addoncommands\Enhancements\UPDATE DATA FILE.htm=Integer Value
WAIT FOR FILE MAP EVENT=addoncommands\Enhancements\WAIT FOR FILE MAP EVENT.htm=Integer Value
DELETE OGG VORBIS=addoncommands\EnhancementsOV\DELETE OGG VORBIS.htm=ID
ENCODE TO OGG VORBIS=addoncommands\EnhancementsOV\ENCODE TO OGG VORBIS.htm=[Input File, Output File][Input File, Output File, Quality]
GET OGG VORBIS EXISTS=addoncommands\EnhancementsOV\GET OGG VORBIS EXISTS.htm=(ID)
GET OGG VORBIS STATE=addoncommands\EnhancementsOV\GET OGG VORBIS STATE.htm=(ID)
GET OGG VORBIS VOLUME=addoncommands\EnhancementsOV\GET OGG VORBIS VOLUME.htm=(ID)
LOAD OGG VORBIS=addoncommands\EnhancementsOV\LOAD OGG VORBIS.htm=Filename, ID
LOOP OGG VORBIS=addoncommands\EnhancementsOV\LOOP OGG VORBIS.htm=ID
PAUSE OGG VORBIS=addoncommands\EnhancementsOV\PAUSE OGG VORBIS.htm=ID
PLAY OGG VORBIS=addoncommands\EnhancementsOV\PLAY OGG VORBIS.htm=ID
RESUME OGG VORBIS=addoncommands\EnhancementsOV\RESUME OGG VORBIS.htm=ID
SET OGG VORBIS VOLUME=addoncommands\EnhancementsOV\SET OGG VORBIS VOLUME.htm=ID, Volume
STOP OGG VORBIS=addoncommands\EnhancementsOV\STOP OGG VORBIS.htm=ID
